9000000000009
9099999999909
9095555555909
9095000005909
9095055505909
9095055505909
9095000005909
9095555555909
9099999999909
9000000000009
