9990099955555999
9900999559995599
9009995599099559
0099955990009955
0999559900900995
9995599009590099
0999559900900995
0099955990009955
9009995599099559
9900999559995599
