0000000555555555
0555000900095555
0555999900099999
0999555555599999
0999555555599999
0000000000000000
9999555005550000
9999555005550000
5555999000000999
5555999000000999
