0000099999999999
0000099999999999
0009999999999999
0090055555555999
0090055555555999
5595500000055999
5595500000055999
5559999990055999
5555599990055999
5555599990055999
