0000000000000000
0555555500000990
0500000500000990
0505550500000000
0505950500999990
0505950500900090
0505550500905090
0500000500900090
0555555500999990
0000000000000000
