5555552227755555
5555552227755555
5555552227755555
5555552227755555
5555052227755555
5550052227755555
5500000000000055
5550052227755555
5555052227755555
5555552227755555
