0000000555555555
0555000722275555
0555777722277777
0777555555577777
0777555555577777
0000200000000000
7777555005550000
7777555005550000
5555777000000222
5555777000000222