0000000000050000
0000000000500000
0000000005000000
0000000020000000
0000000500000000
0000005000000000
0000050000007070
0000500000000700
0005000000007070
0050000000000000
