0022000050050000
0022000500500000
5500002005000000
5500050020000000
0000500500000000
0005005000000000
0050050000007070
0500500000000700
0005000000007070
0050000000000000
