0000000050000000
0000000200000000
0000005000007070
0000050500000700
0000200020007070
0005000005000000
0050070700500000
0500007000050000
5000070700005000
0000000000000500
