7777750220577777
7552550220552557
7552500000052557
7227577227757227
7000700550070007
7000700550070007
0227077227707220
7552000000002557
0552000770002550
2070707777070702
