4444466666666666
4444466677764446
6444666676764646
6646666676769646
6646999676969646
6646969676999646
6446969676666646
6466969696666444
6444969996664444
6666666666664444
