4666466666666666
4464466677767746
6444666676767696
6646666676769696
6646999676969646
6696969676999646
6496969676666646
6766969696666444
6777969996664464
6666666666664666
