6994666499999666
9964464466669664
9666444667779774
6676646777449444
4474446744469676
4676666746999676
4677666746966676
4667644749996777
4444446799697767
6667777796667666
