6664666499999666
6764464496669664
6766444697777774
6776646777444474
4474446744469676
4979999746999676
4977666746966676
4967644749996777
4444446799697767
6967777796667666
