6666666666666666
6999999677777666
6966669676667666
6964444444667666
6964669674667666
6964669677777666
6999999664699996
6664666664696696
6664444444699996
6666666666666666
