6666777777769996
6666766644744494
6699796646769994
6696797747766664
4494696649996664
4694996649444444
4664666669696777
4444776669696767
6667676669696767
6667776669996777
