6666666644477776
6644449949674476
9949649649677476
9649649999666466
9999644446669996
6646666677769496
6446666674744496
6469999444769996
6444449476766666
6669999677766666
