6994444999999777
6964664664444767
7974674777776777
7964474664676469
7967677774776469
7997999994999999
7644447777776466
7777647664444496
6646647777779696
6644446666669996