0112222111111333
0102002002222303
3132032333330333
3102232002030201
3103033332330201
3113111112111111
3022223333330200
3333023002222210
0020023333331010
0022220000001110