1115115115115111
1115115115115111
1115115115115111
1777777775777771
1115115115115111
1115115115115111
1777775777775771
1115115115115111
1115115115115111
1115115115115111
