1115115115115111
1005005000005001
1115115115115111
1777775777777771
1115115115115111
1115115115115111
1000005000005001
1115115115115111
1775777775777771
1115115115115111

-min=6
-max=6

