1115111115111111
1005000000005001
1115115115115111
1777775775777771
1115115115115111
1115115115115111
1775777775775771
1115115115115111
1000005005000001
1111111115111111
