1151011511151171
0050000000050000
1151011511151171
7777077777757777
1151011511151171
1151011511151171
0050000500000070
1151011511151171
7777077577777777
1151011511151171
