1111111115101011
1111111115101011
1111111115101011
1111111115101011
5555555555505555
1111111115101011
7777777775707777
1111111115101011
7777777777777077
1111111115101011
