1115117111101511
7777777700000000
1115117111101511
5555557555555555
1115117111101511
0000000077707577
1115117111101511
1115117111101511
7775777755505555
1115117111101511
