1111170711101011
5555555555500055
5757575757501057
5555555555500055
1111170711101011
1111177711100011
5555570755555555
5757577757575757
5555570755555555
1111177711100011
