5555510577555515
5500150577555555
5051050577005515
5015050570550555
5100550570550515
1555550570550555
5555510117005515
5555510117555555
5555510117555515
5555510117555555

-min=6
-max=6
