2111111111111112
2100100010001012
2110101010101012
2550505050505052
2550505050505052
2550505050505052
2550505050505052
2110101010101012
2110001000100012
2111111111111112
