2111111111111112
2112122212221212
2112121212121212
2550505050505052
2550505050505052
2550505050505052
2550505050505052
2112121212121212
2112221222122212
2111111111111112
