1111111111111111
1222122212221222
1212121212121212
5050505050505050
5050505050505050
5050505050505050
5050505050505050
1212121212121212
2212221222122212
1111111111111111
