2200002221222122
2202222221222122
2505555521222122
2202211511222122
2222222520000100
2222222520222122
2222222520222122
2222111111111122
2222222520222222
2222222222222222
