2200002221222122
2202222221255555
2505555521252122
2202211511252122
5222222520050000
5000002520252122
5222202520222122
5552101110111122
2222202520222222
2222202222222222
