2200002201222122
2202111100055555
2505155521252122
2202100511252122
5222102520050000
5000222520252122
5225552520222122
5502251110115552
2202252520222252
2200252222222252
-min=6
-max=6

