5511512211212211
5122112122112122
1121551121551121
2211515511515511
2155115122115155
1151221121221151
5511215511215511
5122115122115122
1121551121551121
5511512211512211

-min=8
-max=8
