5511512221212211
5111112111112122
1112551121551121
2222515511515511
2155115122115155
1151221121221151
5511215511215521
5122115122115122
1121551121551121
5511512211522211

-min=7
-max=7
