5511512221212211
5111112111112100
1110551121551101
0000515511515511
0155115122115155
1151221121221151
5511215511215501
5122115122115100
1121551121551101
5511510011500011

-min=7
-max=7
